admin@mail.com	admin
gilsongusmão@mail.com	whateverchrisdav
daurantebelo@mail.com	slavyan
gilsoneiró@mail.com	bonafont
beldoramurtinho@mail.com	delivere
romãoquadros@mail.com	netdostup
vladinoalmada@mail.com	jaws
anderemendonça@mail.com	netdostup
ginjacanela@mail.com	Chery
bétiafarias@mail.com	florit
giovaniquadros@mail.com	didlysquat
orindovilante@mail.com	westcornwall
lilabarreto@mail.com	slavyan
henrietalameira@mail.com	zamiel
tâmaralagoa@mail.com	bottomman
márliaquadros@mail.com	zamiel
liladelgado@mail.com	mermes
cisinacovinha@mail.com	weezerjp
beldoracavaco@mail.com	willingham
juventinoespinosa@mail.com	accord
rómulaamaral@mail.com	HAPPYS
ginjamurtinho@mail.com	heartbrk
jordanacharneca@mail.com	longacre
nelsabouça@mail.com	Malonian
autamurtinho@mail.com	Marcello
irménianascimento@mail.com	castafiore
amenaarouca@mail.com	sagehill
nunomaia@mail.com	vorkitdan
bétiaguerra@mail.com	netdostup
orlandinoprotásio@mail.com	alhana
márliarosário@mail.com	longacre
iancoespinosa@mail.com	florit
injailaureano@mail.com	zudina
tâmaraarouca@mail.com	westen
jaminepinho@mail.com	bestfriends
maribelaraposo@mail.com	geetz
adíliarios@mail.com	vorkitdan
serenapescada@mail.com	baronne
josabetehilário@mail.com	jaws
betobarreto@mail.com	baronne
orindohilário@mail.com	Malonian
iancotuna@mail.com	florit
jobelinaduarte@mail.com	snowball
beldoracésar@mail.com	Marcello
jasmimguerra@mail.com	faisca
serenabingre@mail.com	invision
idáliapatrício@mail.com	Chery
amenatravassos@mail.com	bonafont
injaialencar@mail.com	youspyf
engráciocésar@mail.com	zemidear
idáliaprotásio@mail.com	slavyan
giovanimelgaço@mail.com	memonn
serenadoutel@mail.com	xoofiany
rebecanascimento@mail.com	djpapa
drusilamurtinho@mail.com	zululima
alzirindaleite@mail.com	zamiel
dénilamaral@mail.com	emilce
nilcexisto@mail.com	centrifugal
almadaquadros@mail.com	emilce
nildramaia@mail.com	woodkey
jenniferhilário@mail.com	xoofiany
rómulacovinha@mail.com	zululima
jordanacurvelo@mail.com	woodkey
vladinomelgaço@mail.com	yoton
almadafarias@mail.com	Happosai
amadisfreire@mail.com	heartbrk
janimelgaço@mail.com	sexytoes
ermindacésar@mail.com	djpapa
deltinaquadros@mail.com	Giuliano
adíliaxisto@mail.com	bonafont
ismaelfranco@mail.com	zemidear
janialmada@mail.com	woodkey
celinialeite@mail.com	castafiore
lalescanovais@mail.com	Flyguy
ismaelcarrasqueira@mail.com	ntario
dauranteespinosa@mail.com	slavyan
nelsaterra@mail.com	kremer
cheilamangueira@mail.com	castafiore
dairaleite@mail.com	bonafont
horácioargolo@mail.com	nanin
edaletobingre@mail.com	polanski
nubéliafreire@mail.com	emilce
lalescacarrasqueira@mail.com	bras
adeodatoleite@mail.com	sinman
alzirindacarvalheiro@mail.com	zudina
dairagalante@mail.com	zemidear
orindoraposo@mail.com	delivere
josabetedoutel@mail.com	stingem
norbindacarvalheira@mail.com	asstramp
nelsaremígio@mail.com	bestfriends
nunocaeiro@mail.com	bucking
dórdioazeredo@mail.com	castafiore
alzerinapescada@mail.com	snakesnake
aurétioseixas@mail.com	zemidear
aurétiomaciel@mail.com	longacre
adíliabarata@mail.com	accord
socorrolaureano@mail.com	ermaki
tássiabarreto@mail.com	estrad
elilianalaureano@mail.com	alhana
jaminenovais@mail.com	rhinobot
frazinedelgado@mail.com	passsword
nelsamaciel@mail.com	seybool
orlandinobelo@mail.com	vorkitdan
autavilante@mail.com	xoofiany
orindoteodoro@mail.com	westen
cileneleite@mail.com	slithy
edaletovilante@mail.com	screwloo
deltinacafé@mail.com	rhinobot
jordanaesteves@mail.com	polanski
oliveirosvieira@mail.com	seybool
tâniabarreto@mail.com	zudina
cilenetinoco@mail.com	whateverchrisdav
alzerinabingre@mail.com	bukashka
fredericoalmada@mail.com	delivere
nadejeguerra@mail.com	djpapa
drusilateves@mail.com	obnoxious
orindotravassos@mail.com	admin
ismaelfreire@mail.com	heartbrk
irméniaponte@mail.com	admin
alzirindalampreia@mail.com	wolfunderrain
rómulaleite@mail.com	nanin
adeodatomelo@mail.com	Kleine
rodriguesprotásio@mail.com	florit
juventinogago@mail.com	geetz
fávioreis@mail.com	nanin
iancoalencar@mail.com	westen
henrietaamaral@mail.com	invision
vladinoterra@mail.com	kremer
aduínobezerra@mail.com	alhana
deltinacharneca@mail.com	maxter
nunovieira@mail.com	slavyan
didáliamesquita@mail.com	slithy
isaacgoulão@mail.com	centrifugal
juventinobezerra@mail.com	vorkitdan
amenabarata@mail.com	estrad
nunatoste@mail.com	grish
nadejepescada@mail.com	slithy
jóriocaeiro@mail.com	Chery
gilsonesteves@mail.com	screwloo
alissandrolagoa@mail.com	estrad
mártiresbingre@mail.com	trombon
nunomourão@mail.com	whateverchrisdav
drusilabelo@mail.com	admin
orindobouça@mail.com	accord
nunoguerra@mail.com	vorkitdan
altomirândiorosário@mail.com	zudina
mártiresponte@mail.com	westen
aduínolancastre@mail.com	ermaki
nelsalampreia@mail.com	bottomman
cisinarosário@mail.com	whateverchrisdav
fáviocarrilho@mail.com	robwrey
benjamimgrilo@mail.com	parmezan
vladinofreire@mail.com	yoton
aquilpescada@mail.com	Hornets
cilenearouca@mail.com	dokkie
tíliacarvalheiro@mail.com	Chery
rodriguesremígio@mail.com	mermes
micaelapais@mail.com	soepki
isáliabelo@mail.com	notene
tíliabezerra@mail.com	Kleine
ivanteves@mail.com	Giuliano
antoninalancastre@mail.com	passsword
jordanamangueira@mail.com	yugbat
giovanigarrido@mail.com	delivere
alzerinacarmo@mail.com	geetz
fredericoquadros@mail.com	parmezan
nubéliajordão@mail.com	bestfriends
nubéliaperalta@mail.com	TracyT
benjamimrosário@mail.com	ntario
maribelajorge@mail.com	Astika
adeodatorosário@mail.com	castafiore
josabetecesário@mail.com	stingem
giovaniremígio@mail.com	bukashka
ginjapinho@mail.com	sambir
cisinacurvelo@mail.com	Marcello
juventinocaeiro@mail.com	eddiel
jasmimcésar@mail.com	tatijana
brancacafé@mail.com	trombon
idáliajorge@mail.com	tatijana
didáliacharneca@mail.com	geetz
alzirindapinho@mail.com	trombon
amenamaciel@mail.com	daddym
irméniafigueiró@mail.com	screwloo
autanobre@mail.com	sinman
margatuna@mail.com	willingham
almadasesimbra@mail.com	maxter
nunotabosa@mail.com	slithy
almadalancastre@mail.com	maxter
drusilaraposo@mail.com	wolfunderrain
alzerinacavaco@mail.com	Astika
celiniaduarte@mail.com	geetz
bétiamelgaço@mail.com	bottomman
lalescaremígio@mail.com	mermes
henrietanovais@mail.com	tanlines
daurantebouça@mail.com	playerno
tâniapinho@mail.com	zululima
rómulavieira@mail.com	whateverchrisdav
margamesquita@mail.com	kissgapa
mabellancastre@mail.com	Giuliano
maribelagago@mail.com	didlysquat
engráciodelgado@mail.com	netdostup
almecindabezerra@mail.com	dates
nubéliaprotásio@mail.com	invision
almadaalencar@mail.com	tatijana
cilenecharneca@mail.com	vorkitdan
juventinohilário@mail.com	parmezan
vaninefilipe@mail.com	Flyguy
almecindacabreira@mail.com	polemos
jobelinaleite@mail.com	vorkitdan
amenaleite@mail.com	westen
cilenefilipe@mail.com	wicaksana
celiniatuna@mail.com	bestfriends
tâmaranascimento@mail.com	kissgapa
juventinofreire@mail.com	invision
giovaniteodoro@mail.com	delivere
mártiresbouça@mail.com	lindgren
alzirindagarcez@mail.com	trombon
engrácioazeredo@mail.com	invision
lucéliacharneca@mail.com	Flyguy
maribelacesário@mail.com	obnoxious
norbindaponte@mail.com	zudina
ermindamaia@mail.com	screwloo
alzerinaponte@mail.com	mermes
daurantemangueira@mail.com	trombon
horáciodoutel@mail.com	ermaki
irméniacavaco@mail.com	baronne
maribelarios@mail.com	obnoxious
isáliateves@mail.com	willingham
nunomorão@mail.com	slavyan
nilcebezerra@mail.com	willingham
irméniateodoro@mail.com	zamiel
norbindaleme@mail.com	ntario
isaacmendonça@mail.com	fannyfry
ginjaremígio@mail.com	djpapa
jennifergarcez@mail.com	yugbat
cilenecavaco@mail.com	willbar
aurétiorosário@mail.com	polanski
injaileme@mail.com	stingem
alcibíadesxisto@mail.com	jaws
giopalhares@mail.com	grish
jóriofilipe@mail.com	faisca
idáliacabreira@mail.com	nanin
giocarvalheira@mail.com	westen
rodriguesgoulão@mail.com	parmezan
mabelpalhares@mail.com	westen
nubéliaargolo@mail.com	isidro
nunacharneca@mail.com	bonafont
serenalaureano@mail.com	heartbrk
ermindasesimbra@mail.com	didlysquat
almecindalagoa@mail.com	asstramp
juventinopescada@mail.com	bucking
tâniaxisto@mail.com	invision
tâniafranco@mail.com	grish
esperançomourão@mail.com	westcornwall
brancaespinosa@mail.com	heartbrk
margaarouca@mail.com	sergius
lucélianobre@mail.com	alhana
márlianovais@mail.com	asstramp
lalescabingre@mail.com	willingham
gilsonargolo@mail.com	geetz
deltinamesquita@mail.com	sergius
lucéliaargolo@mail.com	asstramp
iancoouro@mail.com	xoofiany
orindopalhares@mail.com	emilce
mártiresálvares@mail.com	vorkitdan
alissandrocavaco@mail.com	soepki
bétiaesteves@mail.com	tatijana
cheilabouça@mail.com	seybool
benjamimbingre@mail.com	longacre
jasmimfilipe@mail.com	passsword
frazinetoste@mail.com	rhinobot
jobelinamelo@mail.com	zemidear
romanapatrício@mail.com	didlysquat
mabelgarrido@mail.com	jaws
ginjacarrilho@mail.com	emilce
fáviomelgaço@mail.com	heartbrk
nilcemaia@mail.com	centrifugal
henrietasesimbra@mail.com	snowball
norbindaxisto@mail.com	screwloo
nubéliajorge@mail.com	heartbrk
adíliadelgado@mail.com	Hornets
aduínoponte@mail.com	stingem
cisinabarata@mail.com	maxter
davíniafigueiró@mail.com	zemidear
didáliamaciel@mail.com	bottomman
liandramaciel@mail.com	eddiel
davíniadoutel@mail.com	soepki
josabeteespinosa@mail.com	isidro
cisinareis@mail.com	zamiel
dénilfarias@mail.com	fannyfry
edaletogarcez@mail.com	invision
dénilgusmão@mail.com	zense
didáliajorge@mail.com	wicaksana
almecindacarvalheira@mail.com	admin
nubéliagalante@mail.com	invision
autaperalta@mail.com	tanlines
socorrobingre@mail.com	bestfriends
elilianaleme@mail.com	bonafont
horácioquadros@mail.com	bottomman
brancacabreira@mail.com	eddiel
tíliabarreto@mail.com	geetz
idálialancastre@mail.com	dates
benjamimseixas@mail.com	TracyT
nelsaamaral@mail.com	bestfriends
elilianavilante@mail.com	youspyf
romãopalhares@mail.com	castafiore
amadisfranco@mail.com	westcornwall
jobelinacurvelo@mail.com	daddym
vladinogago@mail.com	zamiel
josabeteouro@mail.com	lindgren
adílialobo@mail.com	vorkitdan
orandinolagoa@mail.com	slithy
janicarvalheiro@mail.com	centrifugal
juventinogarrido@mail.com	fannyfry
amadisvieira@mail.com	sinman
nelsaeiró@mail.com	admin
dairagago@mail.com	robwrey
aurétioazeredo@mail.com	nanin
nunoeiró@mail.com	geetz
jamineazeredo@mail.com	bukashka
orandinogalante@mail.com	vorkitdan
nadejetinoco@mail.com	Giuliano
autajordão@mail.com	ermaki
celiniaespinosa@mail.com	zululima
esperançoremígio@mail.com	rhinobot
almadacabreira@mail.com	willingham
margaazeredo@mail.com	admin
rebecafreire@mail.com	djpapa
dauranteteves@mail.com	dokkie
márliacovinha@mail.com	robwrey
nelsateves@mail.com	bonafont
lucéliarosário@mail.com	bucking
socorrogalante@mail.com	zemidear
bétiaouro@mail.com	sagehill
tâmaragarcia@mail.com	maxter
juventinoxisto@mail.com	sagehill
lucéliatuna@mail.com	centrifugal
jóriotinoco@mail.com	wallyboy
vladinogalante@mail.com	lindgren
lalescacarrilho@mail.com	Astika
ismaeleiró@mail.com	wallyboy
idáliacesário@mail.com	wicaksana
lucéliacafé@mail.com	obnoxious
tíliaesteves@mail.com	sambir
fáviobouça@mail.com	asstramp
juventinofarias@mail.com	Kleine
fáviopinho@mail.com	accord
liandrareis@mail.com	zamiel
margacurvelo@mail.com	bonafont
jaminecésar@mail.com	weezerjp
josabetecavaco@mail.com	invision
fredericogarrido@mail.com	Marcello
betomourão@mail.com	bottomman
rebecaálvares@mail.com	sinman
norbindatinoco@mail.com	Astika
nilceraposo@mail.com	nanin
josabeteargolo@mail.com	invision
alzerinalaureano@mail.com	willingham
autapinho@mail.com	bucking
romãoouro@mail.com	bestfriends
tâmarajordão@mail.com	wolfunderrain
dairaseixas@mail.com	Happosai
idáliadelgado@mail.com	snakesnake
dénilnascimento@mail.com	isidro
drusilaespinosa@mail.com	invision
romãogarcia@mail.com	sagehill
esperançonobre@mail.com	isidro
brancapescada@mail.com	vorkitdan
almecindaálvares@mail.com	bestfriends
orindoalencar@mail.com	faisca
jennifercarmo@mail.com	invision
janijorge@mail.com	bukashka
serenacesário@mail.com	asstramp
tâmaracesário@mail.com	faisca
cisinalancastre@mail.com	kremer
brancaperalta@mail.com	netdostup
tâmaratinoco@mail.com	dokkie
beldoraprotásio@mail.com	lindgren
giovanibarreto@mail.com	accord
antoninalameira@mail.com	weezerjp
lilacarvalheiro@mail.com	slithy
jobelinapatrício@mail.com	Flyguy
altomirândiocarvalheiro@mail.com	isidro
adíliateodoro@mail.com	nanin
adíliatravassos@mail.com	Giuliano
rómulagago@mail.com	faisca
almadaarouca@mail.com	zudina
antoninacaeiro@mail.com	Giuliano
jennifercanela@mail.com	polemos
tíliatravassos@mail.com	fannyfry
giomaia@mail.com	sergius
alzerinafarias@mail.com	memonn
betolobo@mail.com	invision
gilsonouro@mail.com	woodkey
adeodatoponte@mail.com	seybool
ismaelcarvalheira@mail.com	ntario
ivanbarata@mail.com	sambir
jaminerosário@mail.com	archik
liandrasesimbra@mail.com	whateverchrisdav
alzirindaterra@mail.com	yoton
alissandrodelgado@mail.com	Malonian
orindopais@mail.com	heartbrk
márliaperalta@mail.com	slavyan
ivantabosa@mail.com	eddiel
cisinavilante@mail.com	estrad
adeodatodoutel@mail.com	whateverchrisdav
norbindapais@mail.com	bottomman
anderecarvalheira@mail.com	ntario
mabelmourão@mail.com	daddym
amenalaureano@mail.com	Giuliano
orlandinofreire@mail.com	westen
nunapalhares@mail.com	netdostup
davíniaraposo@mail.com	delivere
bétialampreia@mail.com	slavyan
almadamaia@mail.com	castafiore
nilcebingre@mail.com	djpapa
josabetetoste@mail.com	sambir
nunogarrido@mail.com	bonafont
giovanireis@mail.com	geetz
amadisremígio@mail.com	woodkey
jasmimprotásio@mail.com	woodkey
rodriguescarrilho@mail.com	westen
jordanatuna@mail.com	bucking
injaibingre@mail.com	maxter
jobelinaperalta@mail.com	westcornwall
isáliaeiró@mail.com	Marcello
vanineseixas@mail.com	emilce
jamineduarte@mail.com	Hornets
ivangarcia@mail.com	kissgapa
gilsonvilante@mail.com	nanin
serenamesquita@mail.com	netdostup
aduínoleme@mail.com	soepki
dairapais@mail.com	daddym
giovanixisto@mail.com	woodkey
esperançomaia@mail.com	slavyan
beldoraeiró@mail.com	nankurunaisa
tássiapatrício@mail.com	tanlines
aduínorios@mail.com	slavyan
romanagarrido@mail.com	asstramp
lucéliapescada@mail.com	stingem
socorrocabreira@mail.com	memonn
nunoalencar@mail.com	alhana
mabelesteves@mail.com	snowball
elilianamelgaço@mail.com	ntario
anderepais@mail.com	willbar
ermindacharneca@mail.com	didlysquat
altomirândioraposo@mail.com	didlysquat
dénilmangueira@mail.com	asstramp
rómulaálvares@mail.com	slavyan
tâmarapatrício@mail.com	sambir
lilacésar@mail.com	maxter
adeodatocarmo@mail.com	TracyT
nubéliahilário@mail.com	Happosai
ginjatuna@mail.com	vorkitdan
jaminemorão@mail.com	playerno
jórioterra@mail.com	Malonian
orandinocovinha@mail.com	delivere
frazineleite@mail.com	sagehill
mártiresvieira@mail.com	zamiel
jobelinalameira@mail.com	xoofiany
tâmaralameira@mail.com	HAPPYS
jasmimsesimbra@mail.com	Kleine
nilcemourão@mail.com	rhinobot
socorrovilante@mail.com	accord
isaacnovais@mail.com	stingem
vaninetinoco@mail.com	kissgapa
tíliacavaco@mail.com	passsword
nunanovais@mail.com	Happosai
tâmaralampreia@mail.com	willbar
ismaelmurtinho@mail.com	alhana
lucélialampreia@mail.com	youspyf
nunacafé@mail.com	didlysquat
cisinamourão@mail.com	playerno
aurétiopalhares@mail.com	lindgren
jordanacarvalheira@mail.com	wicaksana
serenapalhares@mail.com	sinman
nunaprotásio@mail.com	zamiel
adíliaquadros@mail.com	trombon
isáliasesimbra@mail.com	trombon
tânialampreia@mail.com	didlysquat
ermindalobo@mail.com	wolfunderrain
aquilcarvalheira@mail.com	snakesnake
aduínogrilo@mail.com	sergius
rómulatinoco@mail.com	snakesnake
edaletofarias@mail.com	zudina
isáliagrilo@mail.com	polemos
alissandronascimento@mail.com	Marcello
vaninemangueira@mail.com	Flyguy
mabelalencar@mail.com	maxter
mártiresquadros@mail.com	Happosai
autalobo@mail.com	Marcello
aquilnobre@mail.com	bras
tássianobre@mail.com	eddiel
nadejetuna@mail.com	tatijana
altomirândiolancastre@mail.com	ermaki
juventinoguerra@mail.com	trombon
janirosário@mail.com	robwrey
beldoralampreia@mail.com	HAPPYS
romãomourão@mail.com	willingham
celiniateves@mail.com	bottomman
nubéliabingre@mail.com	passsword
beldorapalhares@mail.com	dates
fáviolobo@mail.com	stingem
tássialancastre@mail.com	ermaki
maribelareis@mail.com	sagehill
nadejecarvalheira@mail.com	Marcello
orlandinoazeredo@mail.com	xoofiany
tíliaarouca@mail.com	trombon
rómulapatrício@mail.com	Flyguy
alzerinamaia@mail.com	ntario
gilsontuna@mail.com	sinman
autacarvalheiro@mail.com	yugbat
rebecaraposo@mail.com	seybool
almecindacarrilho@mail.com	florit
micaelagusmão@mail.com	Flyguy
ismaelpinho@mail.com	parmezan
aduínocafé@mail.com	didlysquat
nunogrilo@mail.com	dokkie
lalescafranco@mail.com	castafiore
janitravassos@mail.com	sergius
rómulaterra@mail.com	didlysquat
serenavilante@mail.com	screwloo
davíniajordão@mail.com	screwloo
liandragrilo@mail.com	kremer
adíliacurvelo@mail.com	invision
celiniaalencar@mail.com	TracyT
romanaespinosa@mail.com	sambir
edaletomelgaço@mail.com	estrad
henrietalagoa@mail.com	admin
jobelinaquadros@mail.com	grish
nadejebarata@mail.com	Kleine
didáliaterra@mail.com	netdostup
antoninatinoco@mail.com	xoofiany
beldorarosário@mail.com	Chery
almadabezerra@mail.com	zudina
fredericocharneca@mail.com	westen
eliliananovais@mail.com	daddym
nadejepalhares@mail.com	wicaksana
cheilagodinho@mail.com	archik
injainovais@mail.com	dates
jóriocovinha@mail.com	sagehill
lucéliaarouca@mail.com	zudina
vladinoduarte@mail.com	wicaksana
janinobre@mail.com	ermaki
beldoraremígio@mail.com	woodkey
amadisgusmão@mail.com	passsword
mártiresbelo@mail.com	archik
jordanaespinosa@mail.com	vorkitdan
socorroespinosa@mail.com	bukashka
fredericolameira@mail.com	zamiel
orandinocanela@mail.com	sagehill
josabetecarrasqueira@mail.com	nanin
márliamurtinho@mail.com	passsword
nelsafarias@mail.com	dokkie
cilenetabosa@mail.com	tanlines
tíliafigueiró@mail.com	ntario
jordanajorge@mail.com	soepki
jobelinamorão@mail.com	bestfriends
amenacésar@mail.com	ntario
deltinavilante@mail.com	bucking
alzerinaxisto@mail.com	Astika
brancajordão@mail.com	xoofiany
tíliabouça@mail.com	florit
alzerinatabosa@mail.com	xoofiany
dénildelgado@mail.com	nanin
romãopatrício@mail.com	wolfunderrain
vladinolagoa@mail.com	westen
jordanagrilo@mail.com	emilce
mabellaureano@mail.com	grish
nadejejordão@mail.com	playerno
didáliacovinha@mail.com	slavyan
horáciomourão@mail.com	bras
margacesário@mail.com	Marcello
cilenenovais@mail.com	wolfunderrain
janipescada@mail.com	kissgapa
jobelinajordão@mail.com	eddiel
giovanicarrasqueira@mail.com	zense
almadabarata@mail.com	sergius
maribelaarouca@mail.com	heartbrk
alzirindacarrasqueira@mail.com	maxter
oliveirosgalante@mail.com	wicaksana
nildragrilo@mail.com	wolfunderrain
daurantemurtinho@mail.com	stingem
elilianaguerra@mail.com	robwrey
josabetelampreia@mail.com	bucking
nubéliacurvelo@mail.com	screwloo
tâmaracafé@mail.com	vorkitdan
bétiagusmão@mail.com	bucking
elilianavieira@mail.com	yugbat
irméniacovinha@mail.com	wicaksana
horáciobelo@mail.com	estrad
isáliafilipe@mail.com	castafiore
tânialobo@mail.com	nanin
altomirândioalmada@mail.com	rhinobot
nunopais@mail.com	djpapa
edaletolampreia@mail.com	kissgapa
serenacarrasqueira@mail.com	florit
horáciocésar@mail.com	weezerjp
gioxisto@mail.com	Hornets
vladinoteves@mail.com	passsword
andererios@mail.com	slithy
jordanalampreia@mail.com	weezerjp
drusilapinho@mail.com	grish
jordanagodinho@mail.com	playerno
anderetravassos@mail.com	didlysquat
altomirândiogodinho@mail.com	nanin
elilianapescada@mail.com	jaws
jordananovais@mail.com	playerno
micaelaterra@mail.com	woodkey
nunocanela@mail.com	accord
antoninatabosa@mail.com	zululima
nilcereis@mail.com	passsword
adeodatolancastre@mail.com	sergius
engráciobarata@mail.com	bukashka
maribelamorão@mail.com	wolfunderrain
drusilaxisto@mail.com	lindgren
orindonascimento@mail.com	eddiel
jordanateves@mail.com	zemidear
alzerinacafé@mail.com	archik
giocarrilho@mail.com	didlysquat
lucéliacanela@mail.com	delivere
jaminemaia@mail.com	willbar
dénilfreire@mail.com	sagehill
ismaelcarmo@mail.com	zemidear
bétiaálvares@mail.com	notene
micaelateodoro@mail.com	baronne
tâmaratuna@mail.com	emilce
janibelo@mail.com	castafiore
fáviocanela@mail.com	bestfriends
josabeteduarte@mail.com	zululima
cheilalancastre@mail.com	didlysquat
henrietacaeiro@mail.com	whysoserious
rebecaeiró@mail.com	bucking
ermindadoutel@mail.com	ntario
nunoouro@mail.com	Giuliano
celiniagoulão@mail.com	xoofiany
liandragarrido@mail.com	bras
nelsamelo@mail.com	Astika
aurétiorios@mail.com	weezerjp
gioouro@mail.com	slithy
norbindateves@mail.com	tanlines
nildramaciel@mail.com	kissgapa
adeodatoduarte@mail.com	notene
jobelinanovais@mail.com	robwrey
gilsonmelo@mail.com	Marcello
giotabosa@mail.com	Chery
juventinogusmão@mail.com	dokkie
ismaelmesquita@mail.com	bonafont
socorroalmada@mail.com	bucking
ivanpinho@mail.com	snowball
cilenesesimbra@mail.com	castafiore
mabelcovinha@mail.com	maxter
almecindapalhares@mail.com	westen
oliveirosbarata@mail.com	bestfriends
ismaellagoa@mail.com	sinman
mabelmorão@mail.com	sinman
rodriguesbouça@mail.com	yugbat
amenamaia@mail.com	bras
aquiltabosa@mail.com	tatijana
brancaargolo@mail.com	alhana
micaelagodinho@mail.com	nankurunaisa
janipinho@mail.com	zululima
mártiresgrilo@mail.com	ermaki
almecindateodoro@mail.com	whysoserious
celiniacaeiro@mail.com	emilce
tâmaranovais@mail.com	zemidear
cileneponte@mail.com	Malonian
cilenegoulão@mail.com	eddiel
jobelinacarrasqueira@mail.com	parmezan
márliaesteves@mail.com	zemidear
socorroouro@mail.com	baronne
liandragoulão@mail.com	Marcello
antoninamourão@mail.com	wicaksana
ermindafilipe@mail.com	dates
daurantealencar@mail.com	dokkie
fredericomesquita@mail.com	Giuliano
márlialaureano@mail.com	castafiore
mártiresprotásio@mail.com	castafiore
benjamimesteves@mail.com	Astika
oliveiroscarrasqueira@mail.com	whateverchrisdav
alzirindatuna@mail.com	jaws
esperançolameira@mail.com	fannyfry
adeodatojorge@mail.com	lindgren
ermindacurvelo@mail.com	centrifugal
edaletocabreira@mail.com	zudina
engrácioduarte@mail.com	sexytoes
jasmimcafé@mail.com	HAPPYS
giovaniterra@mail.com	slavyan
elilianaouro@mail.com	bottomman
norbindabezerra@mail.com	emilce
aduínotravassos@mail.com	dates
ginjamangueira@mail.com	woodkey
jennifernobre@mail.com	maxter
anderejorge@mail.com	kissgapa
almadaremígio@mail.com	weezerjp
adíliamurtinho@mail.com	baronne
alissandroleite@mail.com	passsword
nilcefranco@mail.com	fannyfry
frazinegusmão@mail.com	eddiel
romanacarrasqueira@mail.com	willbar
aquilxisto@mail.com	nanin
antoninapais@mail.com	daddym
tássiaalencar@mail.com	zululima
almecindalameira@mail.com	bonafont
almadalampreia@mail.com	djpapa
fredericobezerra@mail.com	screwloo
didáliafilipe@mail.com	dates
edaletopatrício@mail.com	bucking
ginjalancastre@mail.com	zense
fáviogarcez@mail.com	kissgapa
lalescaraposo@mail.com	lindgren
orlandinocesário@mail.com	whateverchrisdav
horáciocurvelo@mail.com	dokkie
fredericofranco@mail.com	nanin
ermindaremígio@mail.com	snowball
autacharneca@mail.com	grish
márliaxisto@mail.com	mermes
aquilcurvelo@mail.com	maxter
jóriolagoa@mail.com	zululima
oliveirosbingre@mail.com	robwrey
engráciomurtinho@mail.com	kissgapa
nilcegarcez@mail.com	memonn
nildraperalta@mail.com	stingem
horáciorios@mail.com	dates
didáliacarmo@mail.com	obnoxious
elilianacovinha@mail.com	slavyan
giovanimesquita@mail.com	screwloo
brancalagoa@mail.com	bottomman
betocafé@mail.com	kremer
amenamesquita@mail.com	zudina
nubéliacharneca@mail.com	seybool
vanineamaral@mail.com	polanski
jasmimgalante@mail.com	playerno
lilagalante@mail.com	dates
tíliagarcez@mail.com	castafiore
aduínomelgaço@mail.com	playerno
engráciogrilo@mail.com	stingem
idáliagarrido@mail.com	willingham
adíliacarmo@mail.com	heartbrk
mabelfigueiró@mail.com	dokkie
nadejealmada@mail.com	centrifugal
orandinojordão@mail.com	sagehill
orandinotabosa@mail.com	parmezan
nadejeraposo@mail.com	admin
orandinoalencar@mail.com	dates
cheilalagoa@mail.com	nanin
adeodatoraposo@mail.com	florit
isáliajorge@mail.com	Kleine
jóriomelo@mail.com	admin
tâmaraouro@mail.com	vorkitdan
liandracarvalheiro@mail.com	djpapa
aurétiohilário@mail.com	zamiel
gilsonlaureano@mail.com	wallyboy
altomirândioprotásio@mail.com	daddym
deltinatoste@mail.com	notene
jaminegalante@mail.com	willbar
jennifercavaco@mail.com	ntario
romãocesário@mail.com	yoton
alzerinareis@mail.com	Malonian
vaninecurvelo@mail.com	geetz
josabetereis@mail.com	emilce
fáviocarmo@mail.com	parmezan
juventinojorge@mail.com	zululima
deltinatabosa@mail.com	eddiel
tâniareis@mail.com	willingham
benjamimponte@mail.com	bucking
vaninecavaco@mail.com	woodkey
tâmaravilante@mail.com	HAPPYS
betoouro@mail.com	bras
tíliaeiró@mail.com	fannyfry
aquiltuna@mail.com	Flyguy
janiargolo@mail.com	baronne
nadejeouro@mail.com	tanlines
romanaprotásio@mail.com	dates
oliveirosazeredo@mail.com	snakesnake
ermindaxisto@mail.com	youspyf
altomirândiotinoco@mail.com	yugbat
jenniferfranco@mail.com	weezerjp
oliveiroslaureano@mail.com	fannyfry
jenniferjorge@mail.com	archik
engrácioalmada@mail.com	castafiore
adílianascimento@mail.com	accord
ermindamurtinho@mail.com	zululima
alzerinamurtinho@mail.com	bonafont
esperançonascimento@mail.com	archik
idáliacarmo@mail.com	eddiel
nadejetabosa@mail.com	tatijana
drusilacovinha@mail.com	sagehill
elilianaduarte@mail.com	Flyguy
injaimurtinho@mail.com	Malonian
orindogarrido@mail.com	tatijana
dairareis@mail.com	seybool
jamineraposo@mail.com	maxter
jenniferteves@mail.com	Chery
juventinomaia@mail.com	jaws
frazineperalta@mail.com	eddiel
edaletoxisto@mail.com	zense
autacésar@mail.com	zense
aquillancastre@mail.com	vorkitdan
dórdiolameira@mail.com	admin
vladinohilário@mail.com	isidro
altomirândiojorge@mail.com	Astika
idáliabarreto@mail.com	obnoxious
romãonovais@mail.com	youspyf
orlandinocurvelo@mail.com	yugbat
vladinofigueiró@mail.com	xoofiany
orandinopinho@mail.com	Giuliano
dairafilipe@mail.com	TracyT
ivanfranco@mail.com	zamiel
vaninegoulão@mail.com	heartbrk
frazinefranco@mail.com	bucking
socorropinho@mail.com	bottomman
gilsoncharneca@mail.com	castafiore
benjamimjorge@mail.com	whateverchrisdav
maribelagarcia@mail.com	whateverchrisdav
nelsasesimbra@mail.com	estrad
giovanicavaco@mail.com	netdostup
cisinamorão@mail.com	zamiel
didáliahilário@mail.com	zemidear
almecindajorge@mail.com	delivere
autabingre@mail.com	vorkitdan
vaninealmada@mail.com	Malonian
celiniagalante@mail.com	HAPPYS
ivanouro@mail.com	slavyan
jennifereiró@mail.com	djpapa
jobelinaremígio@mail.com	yugbat
tílialameira@mail.com	Happosai
nelsagrilo@mail.com	isidro
nildramangueira@mail.com	youspyf
lalescamesquita@mail.com	stingem
davíniamangueira@mail.com	Happosai
ivancanela@mail.com	HAPPYS
almecindatabosa@mail.com	djpapa
nunocarvalheiro@mail.com	memonn
lilateodoro@mail.com	bucking
deltinateodoro@mail.com	whysoserious
celiniamurtinho@mail.com	snakesnake
amenaalencar@mail.com	Flyguy
almadafilipe@mail.com	notene
celiniatoste@mail.com	willbar
cheilagoulão@mail.com	HAPPYS
juventinomourão@mail.com	whateverchrisdav
tâniapescada@mail.com	westcornwall
margapalhares@mail.com	yugbat
almecindatinoco@mail.com	wicaksana
norbindapinho@mail.com	nankurunaisa
almecindaprotásio@mail.com	Astika
nadejegago@mail.com	lindgren
amadispatrício@mail.com	lindgren
dairanascimento@mail.com	xoofiany
idáliacaeiro@mail.com	zemidear
jobelinaprotásio@mail.com	dates
cheilaargolo@mail.com	lindgren
rebecafranco@mail.com	estrad
aduínoterra@mail.com	seybool
benjamimgago@mail.com	Malonian
betotabosa@mail.com	Flyguy
gilsonnascimento@mail.com	bottomman
cilenegago@mail.com	Happosai
isáliacavaco@mail.com	didlysquat
tâmaracovinha@mail.com	didlysquat
nildraxisto@mail.com	tanlines
iancocurvelo@mail.com	zense
injaihilário@mail.com	Astika
mártirestravassos@mail.com	yoton
josabetepinho@mail.com	playerno
dairaálvares@mail.com	maxter
rómulajordão@mail.com	seybool
aurétioxisto@mail.com	tatijana
norbindaguerra@mail.com	screwloo
alcibíadestuna@mail.com	trombon
horáciofigueiró@mail.com	notene
adeodatolagoa@mail.com	eddiel
celiniacarrilho@mail.com	florit
aurétiogago@mail.com	bottomman
henrietarosário@mail.com	rhinobot
rodriguestabosa@mail.com	screwloo
jobelinacabreira@mail.com	nanin
rodriguescavaco@mail.com	parmezan
drusilagarcez@mail.com	passsword
alzirindadoutel@mail.com	dates
ginjaálvares@mail.com	obnoxious
vaninebezerra@mail.com	yoton
isáliapais@mail.com	slavyan
bétiagago@mail.com	bucking
dénilbelo@mail.com	netdostup
horáciomangueira@mail.com	Chery
irméniahilário@mail.com	alhana
orandinocabreira@mail.com	accord
nunomangueira@mail.com	netdostup
rebecatabosa@mail.com	eddiel
celiniadoutel@mail.com	bras
micaelajorge@mail.com	isidro
gilsonmourão@mail.com	woodkey
henrietaazeredo@mail.com	woodkey
lalescaeiró@mail.com	sagehill
iancolancastre@mail.com	geetz
injaiarouca@mail.com	didlysquat
cilenecabreira@mail.com	lindgren
jamineguerra@mail.com	rhinobot
nelsaazeredo@mail.com	nankurunaisa
orlandinomaciel@mail.com	isidro
giocavaco@mail.com	sambir
micaelalagoa@mail.com	yoton
orandinojorge@mail.com	sambir
micaelaargolo@mail.com	yugbat
maribelacovinha@mail.com	bucking
giojorge@mail.com	parmezan
nilcegarcia@mail.com	Flyguy
benjamimmurtinho@mail.com	fannyfry
autabezerra@mail.com	sambir
daurantecabreira@mail.com	grish
adeodatogusmão@mail.com	Giuliano
aurétioálvares@mail.com	djpapa
esperançocaeiro@mail.com	bestfriends
edaletoleme@mail.com	stingem
jennifergodinho@mail.com	daddym
tâniapatrício@mail.com	alhana
anderetuna@mail.com	bucking
injairemígio@mail.com	whateverchrisdav
didáliafigueiró@mail.com	tatijana
romanalancastre@mail.com	Kleine
nelsafreire@mail.com	seybool
gilsonprotásio@mail.com	memonn
injaipescada@mail.com	polemos
rebecalameira@mail.com	mermes
fredericodoutel@mail.com	fannyfry
jaminetinoco@mail.com	ntario
tássiagarcez@mail.com	grish
norbindacurvelo@mail.com	dokkie
anderecarrilho@mail.com	daddym
didáliapatrício@mail.com	Chery
vaninerosário@mail.com	ntario
ginjabingre@mail.com	robwrey
giovieira@mail.com	whateverchrisdav
liandratoste@mail.com	nankurunaisa
deltinalancastre@mail.com	obnoxious
rodriguesteves@mail.com	willbar
aduínomendonça@mail.com	seybool
engráciolameira@mail.com	Kleine
tíliatinoco@mail.com	dokkie
lucéliagrilo@mail.com	fannyfry
micaelalancastre@mail.com	alhana
micaelamurtinho@mail.com	westen
micaelamaia@mail.com	fannyfry
vaninedoutel@mail.com	archik
mártireslancastre@mail.com	trombon
lalescagalante@mail.com	snowball
rodriguesperalta@mail.com	parmezan
amenalancastre@mail.com	bottomman
ginjavieira@mail.com	isidro
orandinoesteves@mail.com	zemidear
márliaponte@mail.com	estrad
orlandinocavaco@mail.com	vorkitdan
amadislaureano@mail.com	memonn
nilcegoulão@mail.com	sagehill
gioteodoro@mail.com	seybool
alzerinamangueira@mail.com	bras
davíniamorão@mail.com	westcornwall
micaelafranco@mail.com	whysoserious
mabelfreire@mail.com	geetz
